................................................................................
................................................................................
................................................................................
................................................................................
................................................................................
.....A..........................................................................
.....M..........................................................................
................................................................................
................................................................................
................................................................................
................................................................................
................................................................................
................................................................................
................................................................................
................................................................................
...................................TTTTTTTTTT...................................
...................................TTTTTTTTTT...................................
...................................TTTTTTTTTT...................................
...................................TTTTTTTTTT...................................
...................................TTTTTTTTTT...................................
................................................................................
................................................................................
................................................................................
................................................................................
................................................................................
....................#.######.######.######.######.######.###....................
................................................................................
................................................................................
................................................................................
................................................................................
.........................~~~~~~~~~~~~~~~~~~~~~~~~~~~~~~.........................
.........................~~~~~~~~~~~~~~~~~~~~~~~~~~~~~~.........................
.........................~~~~~~~~~~~~~~~~~~~~~~~~~~~~~~.........................
.........................~~~~~~~~~~~~~~~~~~~~~~~~~~~~~~.........................
.........................~~~~~~~~~~~~~~~~~~~~~~~~~~~~~~.........................
................................................................................
................................................................................
................................................................................
................................................................................
................................................................................
................................................................................
................................................................................
................................................................................
................................................................................
..........................................................................a.....
..........................................................................m.....
................................................................................
................................................................................
................................................................................
................................................................................